#######################################
# Syntax Coloring for JUGL Core Libraries
####################################### 
# Class
#######################################

# Core Library Objects
Point	KEYWORD3
IScreen	KEYWORD3
Color	KEYWORD3
DefinedColor	KEYWORD3
Font	KEYWORD3
Sprite	KEYWORD3

#######################################
# Methods and Functions 
#######################################	

# IScreen member functions
Begin	KEYWORD2
Clear	KEYWORD2
Flush	KEYWORD2
End	KEYWORD2
SetColor	KEYWORD2
GetColor	KEYWORD2
DrawPoint	KEYWORD2
DrawHorizontal	KEYWORD2
DrawLine	KEYWORD2
DrawCircle	KEYWORD2
DrawPolygon	KEYWORD2
DrawRectangle	KEYWORD2
FillCircle	KEYWORD2
FillRectangle	KEYWORD2
DrawTriangle	KEYWORD2
FillTriangle	KEYWORD2
GetHeight	KEYWORD2
GetWidth	KEYWORD2
SetCursor	KEYWORD2
SetFont		KEYWORD2
SetTextWrap	KEYWORD2
DrawSprite	KEYWORD2

# Color member functions
Value	KEYWORD2
Red	KEYWORD2
Green	KEYWORD2
Blue	KEYWORD2

# Point members
X	KEYWORD2
Y	KEYWORD2

# Sprite members
GetPixel	KEYWORD2

#######################################
# Constants
#######################################
 
ALICE_BLUE	LITERAL1
ANTIQUE_WHITE	LITERAL1
AQUA	LITERAL1
AQUAMARINE	LITERAL1
AZURE	LITERAL1
BEIGE	LITERAL1
BISQUE	LITERAL1
BLACK	LITERAL1
BLANCHED_ALMOND	LITERAL1
BLUE	LITERAL1
BLUE_VIOLET	LITERAL1
BROWN	LITERAL1
BURLYWOOD	LITERAL1
CADET_BLUE	LITERAL1
CHARTREUSE	LITERAL1
CHOCOLATE	LITERAL1
CORAL	LITERAL1
CORNFLOWER_BLUE	LITERAL1
CORNSILK	LITERAL1
CYAN	LITERAL1
DARK_BLUE	LITERAL1
DARK_CYAN	LITERAL1
DARK_GOLDENROD	LITERAL1
DARK_GRAY	LITERAL1
DARK_GREEN	LITERAL1
DARK_KHAKI	LITERAL1
DARK_MAGENTA	LITERAL1
DARK_OLIVE_GREEN	LITERAL1
DARK_ORANGE	LITERAL1
DARK_ORCHID	LITERAL1
DARK_RED	LITERAL1
DARK_SALMON	LITERAL1
DARK_SEA_GREEN	LITERAL1
DARK_SLATE_BLUE	LITERAL1
DARK_SLATE_GRAY	LITERAL1
DARK_TURQUOISE	LITERAL1
DARK_VIOLET	LITERAL1
DEEP_PINK	LITERAL1
DEEP_SKY_BLUE	LITERAL1
DIM_GRAY	LITERAL1
DODGER_BLUE	LITERAL1
FIREBRICK	LITERAL1
FLORAL_WHITE	LITERAL1
FOREST_GREEN	LITERAL1
FUSCHIA	LITERAL1
GAINSBORO	LITERAL1
GHOST_WHITE	LITERAL1
GOLD	LITERAL1
GOLDENROD	LITERAL1
GRAY	LITERAL1
GREEN	LITERAL1
GREEN_YELLOW	LITERAL1
HONEYDEW	LITERAL1
HOT_PINK	LITERAL1
INDIAN_RED	LITERAL1
IVORY	LITERAL1
KHAKI	LITERAL1
LAVENDER	LITERAL1
LAVENDER_BLUSH	LITERAL1
LAWN_GREEN	LITERAL1
LEMON_CHIFFON	LITERAL1
LIGHT_BLUE	LITERAL1
LIGHT_CORAL	LITERAL1
LIGHT_CYAN	LITERAL1
LIGHT_GOLDENROD	LITERAL1
LIGHT_GOLDENROD_YELLOW	LITERAL1
LIGHT_GRAY	LITERAL1
LIGHT_GREEN	LITERAL1
LIGHT_PINK	LITERAL1
LIGHT_SALMON	LITERAL1
LIGHT_SEA_GREEN	LITERAL1
LIGHT_SKY_BLUE	LITERAL1
LIGHT_SLATE_BLUE	LITERAL1
LIGHT_SLATE_GRAY	LITERAL1
LIGHT_STEEL_BLUE	LITERAL1
LIGHT_YELLOW	LITERAL1
LIME	LITERAL1
LIME_GREEN	LITERAL1
LINEN	LITERAL1
MAGENTA	LITERAL1
MAROON	LITERAL1
MEDIUM_AQUAMARINE	LITERAL1
MEDIUM_BLUE	LITERAL1
MEDIUM_ORCHID	LITERAL1
MEDIUM_PURPLE	LITERAL1
MEDIUM_SEA_GREEN	LITERAL1
MEDIUM_SLATE_BLUE	LITERAL1
MEDIUM_SPRING_GREEN	LITERAL1
MEDIUM_TURQUOISE	LITERAL1
MEDIUM_VIOLET_RED	LITERAL1
MIDNIGHT_BLUE	LITERAL1
MINT_CREAM	LITERAL1
MISTY_ROSE	LITERAL1
MOCCASIN	LITERAL1
NAVAJO_WHITE	LITERAL1
NAVY	LITERAL1
OLD_LACE	LITERAL1
OLIVE	LITERAL1
OLIVE_DRAB	LITERAL1
ORANGE	LITERAL1
ORANGE_RED	LITERAL1
ORCHID	LITERAL1
PALE_GOLDENROD	LITERAL1
PALE_GREEN	LITERAL1
PALE_TURQUOISE	LITERAL1
PALE_VIOLET_RED	LITERAL1
PAPAYA_WHIP	LITERAL1
PEACH_PUFF	LITERAL1
PERU	LITERAL1
PINK	LITERAL1
PLUM	LITERAL1
POWDER_BLUE	LITERAL1
PURPLE	LITERAL1
RED	LITERAL1
ROSY_BROWN	LITERAL1
ROYAL_BLUE	LITERAL1
SADDLE_BROWN	LITERAL1
SALMON	LITERAL1
SANDY_BROWN	LITERAL1
SEA_GREEN	LITERAL1
SEASHELL	LITERAL1
SIENNA	LITERAL1
SILVER	LITERAL1
SKY_BLUE	LITERAL1
SLATE_BLUE	LITERAL1
SLATE_GRAY	LITERAL1
SNOW	LITERAL1
SPRING_GREEN	LITERAL1
STEEL_BLUE	LITERAL1
TAN	LITERAL1
TEAL	LITERAL1
THISTLE	LITERAL1
TOMATO	LITERAL1
TURQUOISE	LITERAL1
VIOLET	LITERAL1
VIOLET_RED	LITERAL1
WHEAT	LITERAL1
WHITE	LITERAL1
WHITE_SMOKE	LITERAL1
YELLOW	LITERAL1
YELLOW_GREEN	LITERAL1